1111111
1000001
1000001
1000C01
1100101
1100011
1000001
10011P1
1001001
1000111
1001001
10000E1
1000001
1100001
1000101
10001C1
1001001
1000001
1111111