1111111111111111111111111
1CC0000000C00C00000000C01
100000C0000C0C0000C000C01
1000C000C0C0000CC00C00001
1CC1000C0C0000C0000000PC1
10C0C00001C0C00C1001000C1
100000C01000000C000000CC1
1010CC10000000C0CC0000001
100CC0C01010C000000C00001
1100C0000000C000000000001
1010000C0C00010000000C001
10C001000000C00C00000C0C1
1CC01EC00000000C0000CC0C1
1000000000000000000000001
1111111111111111111111111