111111111111111111111
100010100000000000001
110000010010010C00011
100000000000101000001
100000000001110001011
100001000010000000001
100001000000000111101
1000P0000000100100001
100000000100010100001
110000010000000001011
1000101E0010000000001
100000001000101000001
100000000110110001101
100000000000000000001
100000000000000000001
111111111111111111111