1111111111111111111
1000000000000C0C001
1000000000001000001
1000000000000000001
1000000000001000001
1000000000110000001
1000000000001000011
1000000000E00P10001
1000000000000010001
1000000000000000001
1000000000000000001
1000000000100001001
1000010000010100001
1000001000000100001
1000000000000000011
1100000000C00000001
1000000001000000001
1000000000000000001
1111111111111111111