11111111111111
10000000000001
1100000000C011
111C00010C0001
110000CC1E0001
11000P00000001
11000C00000001
10010000010001
10000000000001
11111111111111