1111
1011
1001
1001
1E01
1001
10C1
1P01
1001
1001
1111