1111111111111
1000CPE0000k1
1111111111111